###############
#.............#
#..E.......G..#
#.............#
#...........E.#
#.............#
#..G..........#
#.............#
#.......E.....#
#.............#
#..E......G...#
#.............#
#.............#
#.............#
###############