DDDDDDDDDDDDDDDD
DDDDDDDDDDDDDDDD
DDDDDDDDDDDDDDDD
DTTTTTDDDDDTTTTT
DTTTTTDDDDDTTTTT
DTTTTTDDDDDTTTTT
DTTTTTDDDDDTTTTT
DDDDDTDDDDDTDDDD
DDDDDTDDDDDTDDDD
DDDDDTDDDDDTDDDD
DDDDDTDDDDDTDDDD
DDDDDTDDDDDTDDDD
DDDDDTDDDDDTDDDD
DDDDDTDDDDDTDDDD
DDDDDTDDDDDTDDDD
DDDDDTDDDDDTDDDD
DDDDDTDDDDDTDDDD
DDDDDTDDDDDTDDDD
DDDDDTDDDDDTDDDD
DDDDDTDDDDDTDDDD
DDDDDTDDDDDTDDDD
DDDDDTDDDDDTDDDD
DDDDDTDDDDDTDDDD
DDDDDTDDDDDTDDDD
DDDDDTDDDDDTDDDD
DDDDDTDDDDDTDDDD
DDDDDTTTTTTTDDDD
DDDDDTTTTTTTDDDD
DDDDDTTTTTTTDDDD
DDDDDDDDTDDDDDDD
DDDDDDDDTDDDDDDD
DDDDDDDDTDDDDDDD
DDDDDDDDTDDDDDDD
DDDDDDDDTDDDDDDD
DDDDDDDDTDDDDDDD
DDDDDDDDTDDDDDDD
DDDDDDDDTDDDDDDD
DDDDDDDDTDDDDDDD
DDDDDDDDTDDDDDDD
DDDDDDDDTDDDDDDD
DDDDDDDDTDDDDDDD
DDDDDDDDTDDDDDDD
DDDDDDDDTDDDDDDD
DDDDDDDDTDDDDDDD
DDDDDDDDTDDDDDDD
DDDDDDDDTDDDDDDD
DDDDDDDDTDDDDDDD
DDDDDDDDDDDDDDDD
DDDDDDDDDDDDDDDD
DDDDDDDDDDDDDDDD
