DDDDDDDDDDDDDDDD
DDDDDDDDDDDDDDDD
TDDDDDDDDDDTTTTT
TDDDDDDDDDDTTTTT
TDDDDDDDDDDTTTTT
TDDDDDDDDDDTTTTT
TDDDDDDDDDDTDDDD
TDDDDDDDDDDTDDDD
TDDDDDDDDDDTDDDD
TDDDDDDDDDDTDDDD
TDDDDDDDDDDTDDDD
TDDDDDDDDDDTDDDD
TDDDDDDDDDDTDDDD
TDDDDDDDDDDTDDDD
TDDDDDDDDDDTDDDD
TDDDDDDDDDDTDDDD
TDDDDDDDDDDTDDDD
TDDDDDDDDDDTDDDD
TDDDDDDDDDDTDDDD
TDDDDDDDDDDTDDDD
TDDDDDDDDDDTDDDD
TDDDDDDDDDDTDDDD
TDDDDDDDDDDTDDDD
TDDDDDDDDDDTDDDD
TDDDDDDDDDDTDDDD
TDDDDDDDDDDTDDDD
TTTDDDDDDDDTDDDD
TTTDDDDDDDDTDDDD
TTTDDDDDDDDTDDDD
TTTDDDDDDDDTDDDD
TTTDDDDDDDDTDDDD
DDTDDDDDDDDTDDDD
DDTDDDDDDDDTDDDD
DDTDDDDDDDDTDDDD
DDTDDDDDDDDTDDDD
DDTDDDDDDDDTDDDD
DDTTTTDDDDDTDDDD
DDTTTTDDDDDTDDDD
DDTTTTDDDDDTDDDD
DDTTTTDDDDDTDDDD
DDTTTTDDDDDTDDDD
DDDDDTDDDDDTDDDD
DDDDDTDDDDDTDDDD
DDDDDTDDDDDTDDDD
DDDDDTDDDDDTDDDD
DDDDDTDDDDDTDDDD
DDDDDTTTTTTTDDDD
DDDDDTTTTTTTDDDD
DDDDDTTTTTTTDDDD
DDDDDTTTTTTTDDDD
