TileSize:40
##.#############
##.#####G##G#G##
##.##G##G##G####
##.G.....#######
##.##E##E##E####
##.#####E##E####
#####......##..#
####E##E##E#####
##G#######.#####
##E##E##E#.#####
##########.#####
................