TileSize:40
##N#############
##.#####G##G#G##
##.##G##G##G####
##.G.....#######
##.##E##E##E####
##N.####E##E####
##.........##..#
####E##E##E#####
##G#######.#####
##E##E##E#.#####
##########.#####
................