TileSize:40
BBBBBBBBBBBBBBBBBB
B##N#############B
B##.#####G##G#G##B
B##.##G##G##G####B
B##.G.....#######B
B##.##E##E##E####B
B##N.####E##E####B
B##.........##..#B
B####E##E##E#####B
B##G#######.#####B
B##E##E##E#.#####B
B##########.#####B
BBBBBBBBBBBBBBBBBB