TileSize:40
##.#############
##.#####E##G#G##
##.##E##E##G####
##.......#######
##.##E##E##E####
##.#####E##E####
#####......##..#
####E##E##E#####
##G#######.#####
##E##E##E#.#####
##########.#####
................