TileSize:40
BBBBBBBBBBBBBBBBBB
B##G#############B
B##.#####G##G#G##B
B##.##G##G##G####B
B##.#..P..#######B
B##.##E##E##E####B
B##N#####E##E####B
B##N#...........#B
B####E##E##E#####B
B##.#######.#####B
B##.##E##E#.#####B
B##N#######.#####B
BBBBBBBBBBBBBBBBBB