DDDDDDDDDDDDDDDD
DDDDDDDDDDDDDDDD
DDDDDDDDDDDDDDDD
DDDDDDDDDDDDDDDD
DTTTTTTDDDDDDTTD
DTTTTTTDDDDDDTTD
DTTTTTTDDDDDDTTD
DTDDDDTDDDDDDTTD
DTDDDDTDDDDDDTDD
DDDDDDTDDDDDDTDD
DDDDDDTDDDDDDTDD
DDDDDDTDDDDDDTDD
DDDDDDTDDDDDDTDD
DDDDDDTDDDDDDTDD
DDDDDDTDDDDDDTDD
DDDDDDTDDDDDDTDD
DDDDDDTDDDDDDTDD
DDDDDDTDDDDDDTDD
DDDDDDTDDDDDDTDD
DDDDDDTDDDDDDTDD
DDDDDDTDDDDDDTDD
DDDDDDTDDDDDDTDD
DDDDDDTDDDDDDTDD
DDDDDDTDDDDDDTDD
DDDDDDTDDDDDDTDD
DDDDDDTDDDTTTTDD
DDDDDDTDDDTTTTDD
DDDDDDTDDDTTTTDD
DDDDDDTDDDTTTTDD
DDDDDDTDDDTDDDDD
DDDDDDTDDDTDDDDD
DDDDDDTDDDTDDDDD
DDDDDDTDDDTDDDDD
DDDDDDTDDDTDDDDD
DDDDDDTDDDTDDDDD
DDDDDDTDDDTDDDDD
DDDDDDTDDDTDDDDD
DDDDDDTDDDTDDDDD
DDDDDDTDDDTDDDDD
DDDDDDTDDDTDDDDD
DDDDDDTDDDTDDDDD
DDDDDDTDDDTDDDDD
DDDDDDTTTTTDDDDD
DDDDDDTTTTTDDDDD
DDDDDDTTTTTDDDDD
DDDDDDTTTTTDDDDD
DDDDDDDDDDDDDDDD
DDDDDDDDDDDDDDDD
DDDDDDDDDDDDDDDD
DDDDDDDDDDDDDDDD
