TileSize:32
##.#############
##.#####E##E####
##.##E##E##E####
##...........###
##.##E##E##E####
##.#####E##E####
##..............
####E##E##E#####
##########.#####
##E##E##E#.#####
##########.#####
................