TileSize:40
BBBBBBBBBBBBBBBBBB
B##G#############B
B##.#####G##G#G##B
B##.##G##G##G####B
B##.#..P..#######B
B##.##E##########B
B##N#############B
B##N#...........#B
B################B
B##.#######.#####B
B##.#######.#####B
B##N#######.#####B
BBBBBBBBBBBBBBBBBB