TileSize:40
BBBBBBBBBBBBBBBBB
BN###G#####....NB
B.##EE##E##.#G##B
B.G#EE##E##.####B
B.##EEG#EG#.#EEEB
B.##EE##E##.#EEEB
B.##EE##E##.#EEEB
BN.#EE##E##.####B
B#.####G#G#.####B
B#....#####.####B
BE###.#####.###EB
BEE##...P...##EEB
BBBBBBBBBBBBBBBBB