TileSize:40
###############
#......#......#
#..E...#...G..#
#......#......#
#......#....E.#
#.............#
#..G..........#
#.............#
#.......E.....#
#.............#
#..E......G...#
#.............#
#.............#
#.............#
###############